10 10
. . . . . @ . @ . .
. . @ @ . @ . . . .
@ . . . . . . . . .
. . . . . . . . . .
. . @ . . . . . . .
. . . . . . . . . .
. . . . . . . . . .
@ . . @ . . @ . . .
. . . . . . . . . .
. . . . . . . . . .
5
8 7 2 7
2 9 2 4
3 4 6 2
8 0 4 6
3 7 6 7
