8 8
@ . @ . . @ . @
. . . . . . @ .
. . @ @ @ . . @
. . . @ . . . .
. @ . . @ @ . @
@ . . . @ . . @
. @ . . . . . .
@ @ @ @ . . @ @
6
4 2 3 4
6 7 7 4
1 1 4 3
5 1 2 5
5 3 3 5
3 1 0 1
