10 10
. . . . . . . . . .
. . . @ @ . . . @ .
. @ . . @ . . @ . @
@ . . . . . . . @ .
@ . . @ . . . . . .
@ . . . . . . . . @
. . @ @ @ . . . @ .
. . . . @ . . . @ .
. . . . . @ . . @ .
. . . . . . . . @ .
5
9 7 7 0
2 5 4 8
6 0 9 5
1 2 3 1
8 4 4 7
