8 8
@ . . . . . . .
. . . . . . . .
. . . @ . . . .
. . . . . @ . .
. . . . . . . .
. . . . . . . @
. . . . . @ . .
. . . . . . @ .
8
6 4 7 0
2 4 4 1
4 4 1 1
7 2 4 4
4 3 5 5
2 1 4 6
3 4 0 6
1 2 0 5
